                                                                                
                                                       %                        
                                                  %%%%%%%%%                     
                                                      %%%%%%%        ,          
                                                       %%%%%%%%%%%%%%%%  %      
                                                      %%%%%%%%%%%%%%%%%%        
                                                  %%%%%%%%%%%%%%%%  %           
                                                 %%%%%%%%%%%%%%%                
                                                 %%%        %%%%                
                                                  %%%%%                         
                                                   %%%%%                        
                                                  %%%%%%%                       
                                                  #%%%%%%%                      
                                                 .%%%%%%%%%                     
                                                  %%%%%%%%                      
                                                 .%%%%%%%%                      
                                            %#  %%%%%%%%                        
                                        .  %% %%%%%%%%%%                        
                                      %%%  %%%%%%%%%%%%%%                       
                                      % %%%%%%%%%%%%%%%                         
                                    %%%%%%%%%%%%%%%%%%%                         
                                   %%%%%%%%%%%%%%%%%%%%%%                       
                    ,%%%% %%%%%%%%%%%%%%%%%%%%%%%%%% %%                         
                   %%%%%%%%%%%%%%%%%%%%%%%%%% .%,  %%                           
             %%%%%%%%%%%%%%  %% #%%%%%%%                                        
           %%%   %%  %%%%%%%%. %%%%%%%                                          
       %%%%%%%%%%%% %%%%  %%     %                                              
        %%%/%%%%%%% / %                                                         
          /%%%%%(                                                               
         %%%%%%%                                                                
         %%#% %                                                                 
                                                                                
